Zimmer: das Zimmer - zwei Zimmer, = the **room**
Bad: das Bad - zwei Bäder, = the **bathroom**
Balkon: der Balkon - zwei Balkone, = the **balcony**
Fernseher: der Fernseher - zwei Fernseher, = the **TV**
Flur/Flur#1: der Flur - zwei Flure, = the **hallway**
Gerät: das Gerät - zwei Geräte, = the **device / equipment**
Herd: der Herd - zwei Herde, = the **stove**
Maschine: die Maschine - zwei Maschinen, = the **machine**
Kind: das Kind - zwei Kinder, = the **child**
Küche: die Küche - zwei Küchen, = the **kitchen**
Kühlschrank: der Kühlschrank - zwei Kühlschränke, = the **refrigerator**
Lampe/Lampe#1: die Lampe - zwei Lampen, = the **lamp**
Möbel: das Möbel - zwei Möbel, = the **piece of furniture**
Regal/Regal#1: das Regal - zwei Regale, = the **shelf**
Schlafzimmer: das Schlafzimmer - zwei Schlafzimmer, = the **bedroom**
Schrank: der Schrank - zwei Schränke, = the **cupboard**
Schreibtisch: der Schreibtisch - zwei Schreibtische, = the **desk**
Sessel: der Sessel - zwei Sessel, = the **armchair**
Sofa: das Sofa - zwei Sofas, = the **sofa**
Spülmaschine: die Spülmaschine - zwei Spülmaschinen, = the **dishwasher**
Stuhl/Stuhl#1: der Stuhl - zwei Stühle, = the **chair**
Teppich: der Teppich - zwei Teppiche, = the **carpet**
Toilette: die Toilette - zwei Toiletten, = the **toilet**
Waschmaschine: die Waschmaschine - zwei Waschmaschinen, = the **washing machine**
Wohnung: die Wohnung - zwei Wohnungen, = the **flat / apartment**
Wohnzimmer: das Wohnzimmer - zwei Wohnzimmer, = the **living room**
oben: oben, = **above**
Pflanze: die Pflanze - zwei Pflanzen, = the **plant**
ziehen: ziehen, Er zieht. Er hat gezogen., = to **pull**
umziehen: umziehen, Er zieht um. Er ist umgezogen., = to **move** (to another place)
sich umziehen/umziehen: sich umziehen, Er zieht sich um. Er hat sich umgezogen., = to **get changed**
besonders: besonders, = **especially**
Lieblingsort: der Lieblingsort, = the **favorite place** 
Lieblingszimmer/Liebling: das Lieblingszimmer, = the **favorite room** 
hell: hell, Es ist sehr hell., = **bright**
maximal: maximal, = **maximal**
Quadratmeter: der Quadratmeter - zwei Quadratmeter, = **m², square meter**
Terrasse: die Terrasse - zwei Terrassen, = the **terrace**
ungefähr: ungefähr, = **approximately**
Suche: die Suche - zwei Suchen, = the **search**
Zentrum: das Zentrum - zwei Zentren, = the **center**
Miete: die Miete - zwei Mieten, = the **rent**
Wunsch: der Wunsch - zwei Wünsche, = the **wish**
Apartment: das Apartment - zwei Apartments, = the **apartment**
billig: billig, = **cheap**
direkt: direkt, = **direct**
Dusche: die Dusche - zwei Duschen, = the **shower**
elegang: elegant, = **elegant**
ideal: ideal, = **ideal**
jung: jung, = **young**
Nähe: die Nähe, = the **proximity**
renovieren: renovieren. Er renoviert. Er hat renoviert., = **renovated**
Stock/Stock#2: der Stock - zwei Stöcke, = the **storey**
vermieten: vermieten, Er vermietet. Er hat vermietet., = to **rent out**
Fläche: die Fläche - zwei Flächen, = the **area**
Anzeige: die Anzeige - zwei Anzeigen, = the **advertisement**
zentral: zentral, = **central**
dunkel: dunkel, = **dark**
günstig: günstig, = **cheap / inexpensive**
stellen: stellen, Er stellt. Er hat gestellt., = to **place / put**
schwarz: schwarz, = **black**
braun: braun, = **brown** 
grau: grau, = **grey** 
rot: rot, = **red**
orange: orange, = **orange** 
gelb: gelb, = **yellow** 
blau: blau, = **blau**
grün: grün, = **grün**
lila: lila, = **purple / lilac**
weiß: weiß, = **white**
