leben: Er lebt. Er hat gelebt., = to **live**
Kartoffelchip: der Kartoffelchip - zwei Kartoffelchips, = the **potato chip**
Experiment: das Experiment - zwei Experimente, = the **experiment**
wegräumen: wegräumen, Er räumt die Sachen weg. Er hat die Sachen weggeräumt., = to **clear away / put away**
Bett: das Bett - zwei Betten, = the **bed**
egal/egal#1: Das ist mir egal., = **I don't care**. 
der Erste, der Zweite, der Dritte/erste: der Erste, der Zweite, der Dritte, = **the first**, the second, the third
faul: faul, = **lazy**
fit: fit, = **fit**
Freizeit: die Freizeit - die Freizeiten, = the **free time**
hungrig: hungrig, = **hungry**
losgehen: Er geht los. Er ist losgegangen., = to **set off / start walking**
 müde: müde, = **tired**
regelmäßig: regelmäßig, = **regularly**
richtig: richtig, Das ist richtig., = **correct / true**
schaffen: schaffen, Er schafft das. Er hat das geschafft. , = **make / manage / accomplish**
sicher: sicher, = **secure / safe**
Süßigkeit: die Süßigkeit - zwei Süßigkeiten, = the **candy**
täglich: täglich, = **daily**
gefährlich: gefährlich, = **dangerous**
gerade/gerade#2: Er kommt gerade. Er ist gerade gekommen., = **just now**
Nachricht: die Nachricht - zwei Nachrichten, = the **message**
vergessen: vergessen, Er vergisst es. Er hat es vergessen., = to **forget**
vermissen: vermissen, Er vermisst es. Er hat es vermisst., = to **miss**
aktiv: aktiv, = **active**
anziehen: anziehen, Er zieht sich an. Er hat sich angezogen., = to **put on**
Comic: der Comic - zwei Comics., = the **cartoon**
geben: geben, Er gibt mir das Buch. Er hat mir das Buch gegeben., = to **give**
holen: holen, Er holt das Buch. Er hat das Buch geholt., = to **get / fetch**
mindestens: mindestens, = **at least**
rausgehen: rausgehen, Er geht raus. Er ist rausgegangen., = to **go outside**
sportlich: sportlich, = **sporty / athletic**
weitermachen: weitermachen, = to **continue / keep going**
Aufforderung: die Aufforderung - zwei Aufforderungen, = the **request**
ruhig: ruhig, Sei ruhig!, = **quiet**
aufmachen: aufmachen, Er macht die Dose auf. Er hat die Dose aufgemacht., = to **open**
aufschreiben: aufschreiben, Er schreibt den Satz auf. Er hat den Satz aufgeschrieben., = to **write down**
Fenster: das Fenster - zwei Fenster, = the **window**
leise: leise, Sei leise!, = **quiet**
Tafel: die Tafel - zwei Tafeln, = the **board / whiteboard / blackboard**
vorlesen: vorlesen, Er liest dem Kind die Geschichte vor. Er hat dem Kind die Geschichte vorgelesen., = to **read aloud / read out**
wiederholen/wiederholen#2: wiederholen, = to **repeat**
wiegen/wiegen#1: wiegen, Wieviel wiegst du? Der Arzt wiegt sie. Der Arzt hat sie gewogen., = to **weigh**
Alter: das Alter, = the **age**
Gewicht: das Gewicht - zwei Gewichte, = the **weight**
Größe: die Größe - zwei Größen, = the **size / height**
schwer: schwer, = **heavy**
Bauch: der Bauch - zwei Bäuche, = the **belly**
Bein: das Bein - zwei Beine, = the **leg**
Finger: der Finger - zwei Finger, = the **finger**
Fuß: der Fuß - zwei Füße, = the **foot**
Hals/Hals#1: der Hals - zwei Hälse, = the **neck**
Hand: die Hand - zwei Hände, = the **hand**
Knie: das Knie - zwei Knie, = the **knee**
Kopf: der Kopf - zwei Köpfe, = the **head**
Körper: der Körper - zwei Körper, = the **body**
Rücken/Rücken#1: der Rücken - zwei Rücken, = the **back**
Teil: das Teil - zwei Teile, = the **part**
abwechseln: abwechseln. Wir wechseln uns ab. Wir haben uns abgewechselt, = to **take turns**
Auge: das Auge - zwei Augen, = the **eye**
Gesicht: das Gesicht - zwei Gesichter, = the **face**
Haar: das Haar - zwei Haare, = the **hair**
Mund: der Mund - zwei Münder, = the **mouth**
Nase: die Nase - zwei Nasen, = the **nose**
Ohr: das Ohr - zwei Ohren, = the **ear**
Zahn: der Zahn - zwei Zähne, = the **tooth**
Ellbogen: der Ellbogen - zwei Ellbogen, = the **elbow**
riechen: riechen, Das Parfüm riecht gut. Das Parfüm hat gut gerochen., = to **smell**
bekommen: bekommen, Er bekommt ein Geschenk. Er hat ein Geschenk bekommen., = to **get**
Rezept: das Rezept - zwei Rezepte, = the **prescription**
Salbe: die Salbe - zwei Salben, = the **ointment / salve**
Unfall: der Unfall - zwei Unfälle, = the **accident**
Verband/Verband#1: der Verband - zwei Verbände, = the **dressing / bandage**
verletzt: verletzt, = **injured**
Apotheke: die Apotheke - zwei Apotheken, = the **pharmacy**
bewegen/bewegen#1: bewegen. Er bewegt den Arm. Er hat den Arm bewegt., = to **move**
Gute Besserung!/Besserung: Gute Besserung!, = **Get well soon!**
hinlegen: hinlegen, sich hinlegen, = to **lie down**, to lay down
Kontrolle: die Kontrolle - zwei Kontrollen, = the **check**
kontrollieren: kontrollieren, Er kontrolliert. Er hat kontrolliert., = to **check**
sauber machen/saubermachen: sauber machen, Er macht sauber. Er hat sauber gemacht., = to **clean**
Es tut weh./wehtun: Es tut weh. Es hat wehgetan., = **It hurts.**
Wunde: die Wunde - zwei Wunden, = the **wound**
Arzt: der Arzt - zwei Ärzte, = the **doctor**
sofort: sofort, = **immediately**
sollen: sollen, = to **be supposed to**
Schmerz: der Schmerz - zwei Schmerzen, = the **pain**
erlauben: erlauben, Er erlaubt es. Er hat es erlaubt., = to **allow**
sich erkälten/erkälten: sich erkälten, Er erkältet sich. Er hat sich erkältet., = to **catch a cold** 
Fieber: das Fieber - zwei Fieber, = the **fever**
husten: husten, Er hustet. Er hat gehustet., = to **cough**
Mir ist schlecht./schlecht: Mir ist schlecht., = **I feel sick.**
total: total, = **totally**
baden: baden, Er badet. Er hat gebadet., = to **take a bath**
dürfen: dürfen, Er darf., = to **be allowed to**
gegen: gegen, gegen den Wind, gegen die Schmerzen, = **against**
nehmen: nehmen, Er nimmt. Er hat genommen., = to **take**
Husten: der Husten - zwei Husten, = the **cough**
rauchen: rauchen, Er raucht. Er hat geraucht., = to **smoke**
einmal, zweimal, dreimal: einmal, zweimal, dreimal, = **once, twice, three times**
Pflaster: das Pflaster - zwei Pflaster, = the **band-aid**
Tropfen: der Tropfen - zwei Tropfen, = the **drop**
Honig: der Honig, Der Honig ist süß., = the **honey**
Suppe: die Suppe - zwei Suppen, = the **soup**
Nelke: die Nelke - zwei Nelken, = the **clove**
Schnupfen: der Schnupfen - zwei Schnupfen, = the **cold / runny nose**
vermuten: vermuten, Er vermutet. Er hat vermutet., = to **assume**
Bitte: die Bitte - zwei Bitten, = the **request**
einschlafen: einschlafen, Er schläft ein. Er ist eingeschlafen., = to **fall asleep**
Beitrag: der Beitrag - zwei Beiträge, = the **contribution / post**
inhalieren: inhalieren, Er inhaliert. Er hat inhaliert., = to **inhale**
jemand: jemand, = **someone**
perfekt: perfekt, = **perfect**
Huhn: das Huhn - zwei Hühner, = the **chicken**
Tipp/Tipp#1: der Tipp - zwei Tipps, = the **tip / advice**
versuchen: versuchen, Er versucht. Er hat versucht, = to **try**
aufhängen: aufhängen, Er hängt auf. Er hat aufgehängt., = to **hang up**
Zettel/Zettel#1: der Zettel - zwei Zettel, = the **note / piece of paper**
anstrengend: anstrengend, = **exhausting**
Blut: das Blut, = the **blood**
Ergebnis: das Ergebnis - zwei Ergebnisse, = the **result**
Not: die Not - zwei Nöte, = the **misery**
glücklich: glücklich, = **happy**
Sportler: der Sportler - zwei Sportler, = the **athlete**
untersuchen: untersuchen, Er untersucht. Er hat untersucht., = to **examine**
Hilfe: die Hilfe - zwei Hilfen, = the **help**
zerlegen/zerlegen#1: zerlegen, Er zerlegt. Er hat zerlegt., = to **disassemble**
ausdrücken: ausdrücken, Er drückt aus. Er hat ausgedrückt., = to **express**
Ausdruck/Ausdruck#1: der Ausdruck - zwei Ausdrücke, = the **expression**
Erlaubnis: die Erlaubnis - zwei Erlaubnisse, = the **permission**
Verbot: das Verbot - zwei Verbote, = the **prohibition**
wiedergeben: wiedergeben, Er gibt wieder. Er hat wiedergegeben., = to **reproduce**
